111111111111111111111
110010P010CCC000C0111
11C0C01C00CC110C00111
1C00CC1C00CC000C00111
10CCCC0011C1001CC1111
1CC00CC00C100C0C0CC11
11E00CC1C000CC0C0C0C1
111111111111111111111
