11111111
10C000P1
10E00C01
11111111
